The Legend of Z - Nintendo
Shovel Knight: - Yacht Club Game
Shovel Knight: - Yacht Club Game
Fast RMX - 'Shin''en'
Snipperclips - - Nintendo, SFB G
I Am Setsuna - Tokyo RPG Facto
Skylanders Imag - Toys for Bob
Just Dance 2017 - Ubisoft Paris
Super Bomberman - Konami
1-2-Switch - Nintendo
New Frontier Da - Arc System Work
VOEZ - Flyhigh Works
Blaster Master - Inti Creates
ACA NeoGeo: Met - SNK Playmore, H
ACA NeoGeo: Sho - Saurus
World of Goo - Tomorrow Corpor
Human Resource - Tomorrow Corpor
Little Inferno - Tomorrow Corpor
The Binding of - Edmund McMillen
Othello - Arc System Work
Snake Pass - Sumo Digital
Has-Been Heroes - Frozenbyte, Inc
LEGO City Under - TT Games
Vroom in the Ni - Poisoft
Graceful Explos - Vertex Pop
Mr. Shifty - Team Shifty
'Wonder Boy: Th - Lizardcube
Puyo Puyo Tetri - Sonic Team
Kamiko - Skipmore
Mario Kart 8 De - Nintendo
TumbleSeed - Benedict Fritz,
NBA Playgrounds - Saber Interacti
Minecraft: Swit - 4J Studios
Thumper - Drool
Disgaea 5 Compl - Nippon Ichi Sof
Ultra Street Fi - Capcom
Astro Duel Delu - Panic Button
Slime-san - Fabraz
Shantae: Half-G - WayForward
Cars 3: Driven - Avalanche Softw
Mighty Gunvolt - Inti Creates
ARMS - Nintendo
Cave Story + - Nicalis
Oceanhorn: Mons - Cornfox & Bros.
GoNNER - Art in Heart
The Legend of Z - Nintendo
Bulb Boy - Bulbware
Implosion - Nev - Rayark Inc.
Flip Wars - OVER FENCE CO.,
Vaccine - Rainy Night Cre
Death Squared - SMG Studio
De Mambo - The Dangerous K
I and Me - Wish Fang
Splatoon 2 - Nintendo
Fate/Extella: T - Marvelous Inc.
Overcooked!: Sp - Team 17
Namco Museum - Namco
Infinite Minigo - Zen Studios
Sine Mora EX - Grasshopper Man
Ironcast - Dreadbit
Sonic Mania - Tantalus
Mario + Rabbids - Ubisoft, Ubisof
Azure Striker G - Inti Creates
League of Evil - Ratalaika Games
LEGO Worlds - TT Games
NeuroVoider - Flying Oak Game
Lichtspeer: Dou - Crunching Koala
Rayman Legends: - Ubisoft Montpel
Semispheres - Vivid Helix
NBA 2K18 - Visual Concepts
Robonauts - QubicGames
SteamWorld Dig - Image & Form
Thimbleweed Par - Ron Gilbert and
Pokken Tourname - Bandai Namco Ga
Dragon Ball: Xe - Dimps Corporati
Golf Story - SideBar Games
Conga Master Pa - Rising Star Gam
BUTCHER - Transhuman Desi
Picross S - Jupiter Corpora
Astro Bears Par - QubicGames
FIFA 18 - EA Vancouver
One Piece: Unli - Ganbarion
Lovers in a Dan - Asteroid Base
Stardew Valley - ConcernedApe
Axiom Verge - Tom Happ
Earth Atlantis - Pixel Perfex
Oxenfree - Night School St
Tiny Barbarian - StarQuail
88 Heroes: 98 H - Bitmap Bureau
Touhou Kobuto V - CUBETYPE
Wulverblade - Darkwind Media
The Flame in th - The Molasses Fl
Yono and the Ce - Neckbolt
Neon Chrome - 10tons
Rogue Trooper R - Rebellion
The Count Lucan - Baroque Decay
JYDGE - 10tons
Spelunker Party - Tozai Games
Syberia - Koalabs Studio
Fire Emblem War - Omega Force
Poi: Explorer E - PolyKid
The Mummy Demas - WayForward
Just Dance 2018 - Ubisoft Paris
This is the Pol - Weappy Studio
Nights of Azure - Gust
Splasher - Splashteam
Time Recoil - 10tons
Super Mario Ody - Nintendo
Monopoly for Ni - Asobo Studio, E
Chess Ultra - Ripstone
Super Beat Spor - Harmonix Music
Morphite - Crescent Moon G
Farming Simulat - Giants Software
Uno - Ubisoft
Sonic Forces - Sonic Team
Snipperclips Pl - SFB Games
DOOM - id Software, Pa
Cat Quest - The Gentlebros
Rocket League - Psyonix
L.A. Noire - Team Bondi, Vir
Ittle Dew 2+ - Ludosity Intera
Lumo - Rising Star Gam
LEGO Marvel Sup - TT Games
Batman: The Tel - Telltale Games
RiME - Tantalus
The Elder Scrol - Bethesda Game S
RIVE: Ultimate - Two Tribes
VVVVVV - Terry Cavanagh
Aces of the Luf - HandyGames
Battle Chef Bri - Trinket Studios
SUPERBEAT: XONi - Nurijoy
Gear.Club Unlim - Eden Games Mobi
'Unbox: Newbie' - Prospect Games
Portal Knights - Keen Games
Worms W.M.D - Team 17
Mantis Burn Rac - VooFoo Studios
Crimsonland - 10tons
Resident Evil: - Capcom
Resident Evil: - Capcom
Resident Evil: - Capcom
Xenoblade Chron - Monolith Soft
Nine Parchments - Frozenbyte, Inc
Caveman Warrior - JanduSoft
Teslagrad - Rain Games
'The Legend of - Nintendo
Embers of Mirri - Creative Bytes
Floor Kids - Merj Media
Dimension Drive - 2Awesome Studio
The Sexy Brutal - Cavalier Game S
Vostok Inc. - Nosebleed Inter
Human: Fall Fla - No Brakes Games
Pinball FX3 - Zen Studios
The End Is Nigh - Nicalis
Enter the Gunge - Dodge Roll
Mutant Mudds Co - Renegade Kid, A
Gorogoa - Jason Roberts
Yooka-Laylee - Playtonic Games
Bleed - BootdiskRevolut
'Never Stop Sne - Humble Hearts
Romancing SaGa - Square Enix
Brawlout - Angry Mob Games
Blossom Tales: - Castle Pixel, L
The Next Penelo - Aurelien Regard
Max: The Curse - Stage Clear Stu
Mom Hid My Game - Hap
Tiny Metal - AREA35
The Coma: Recut - Devespresso Gam
The Deer God - Cinopt Studios
Sparkle Unleash - 10tons
SteamWorld Heis - Image & Form
Stikbold! Dodge - Game Swing
Super Meat Boy - Team Meat
Furi - The Game Bakers
The Escapists 2 - Team 17, Mouldy
BRAWL - Bloober Team
InnerSpace - PolyKnight Game
Darkest Dungeon - Red Hook Studio
World to the We - Rain Games
Vesta - FinalBoss Games
Baseball Riot - 10tons
ChromaGun - Pixel Maniacs
Shu - Coatsink Softwa
Lost Sphear - Tokyo RPG Facto
Celeste - Matt Makes Game
Super One More - SMG Studio
Fantasy Hero: U - Arc System Work
Crypt of the Ne - Brace Yourself
Night in the Wo - Infinite Fall
SteamWorld Dig: - Image & Form
Sky Force Reloa - Infinite Dreams
Dandara - Raw Fury, Long
Mercenary Kings - Tribute Games
The Darkside De - Spooky Doorway
ATOMIK: RunGunJ - Gambitious
Aegis Defenders - Humble Bundle
Disc Jam - High Horse Ente
Mercenaries Sag - RideonJapan,Inc
Dragon Quest Bu - Square Enix
Owlboy - BlitWorks
The Fall Part 2 - Over The Moon
The Longest Fiv - Nippon Ichi Sof
Aqua Kitty UDX - Tikipod Limited
Xeodrifter - Atooi LLC
Bayonetta 2 - Nintendo
Bayonetta + Bay - PlatinumGames
Bayonetta - Nintendo
'Joe Dever''s L - Bulkypix, Forge
Fe - Zoink!
'Old Man''s Jou - Broken Rules
Layers of Fear: - Bloober Team
Pac-Man Champio - Bandai Namco Ga
Membrane - Perfect Hat
Typoman: Revise - Brainseed Facto
Hollow - MMEU
Toki Tori 2 + - Two Tribes
Outlast: Bundle - Red Barrels
Payday 2 - Sumo Digital, O
Bridge Construc - ClockStone Soft
Detention - Red Candle Game
Subsurface Circ - Mike Bithell
A Normal Lost P - Plug In Digital
Mulaka - Lienzo
Scribblenauts S - Warner Bros. In
Bleed 2 - BootdiskRevolut
Steredenn: Bina - Plug In Digital
Earthlock - Snow Castle Gam
Danmaku Unlimit - Doragon Enterta
Clustertruck - tinyBuild
The Long Reach - Painted Black G
Last Day of Jun - Ovosonico
Tesla vs Lovecr - 10tons
Kirby Star Alli - HAL Labs
'Shantae and th - WayForward
Attack on Titan - Omega Force
'Slayaway Camp: - Blue Wizard Dig
Castle of Heart - 7Levels
Outlast 2 - Red Barrels
Atelier Lydie & - Koei Tecmo Game
Lode Runner Leg - Tozai Games, In
Toki Tori - Two Tribes
Shadow Bug - Muro Studios Lt
Devious Dungeon - Noodlecake Stud
The Adventure P - Massive Monster
Penny-Punching - Nippon Ichi Sof
Pinball FX3: Be - Zen Studios
Urban Trial Pla - Teyon, Tate Mul
Infernium - Carlos Coronado
Masters of Anim - Passtech Games
Super Daryl Del - Dan & Gary Game
Bombslinger - Mode4
Rogue Aces - Infinite State
Skies of Fury D - Seed Interactiv
Regalia: Of Men - Pixelated Milk
Burly Men At Se - Brain&Brain
Shelter Generat - Might and Delig
Football Manage - Sports Interact
Manticore: Gala - Deep Silver
Nintendo Labo: - Nintendo
Nintendo Labo: - Nintendo
The Way Remaste - Puzzling Dream
South Park: The - Ubisoft San Fra
Gal*Gun 2 - Inti Creates
Late Shift - Wales Interacti
Light Fall - Bishop Games
A Robot Named F - Matt Bitner
Naruto Shippude - Bandai Namco Ga
Saturday Mornin - Joystick Labs,
Jotun: Valhalla - Thunder Lotus G
Donkey Kong Cou - Retro Studios
Shantae: Half-G - WayForward
Death Road to C - Rocketcat Games
Raging Justice - MakinGames
Super Chariot - Frima Studio
One Piece: Pira - Koei Tecmo Game
Immortal Rednec - Crema Games
The Fall - Over The Moon
Garage - tinyBuild
Suicide Guy - Chubby Pixel
Battle Chasers: - Airship Syndica
Wizard of Legen - Contingent99
The Banner Saga - Stoic
FRAMED Collecti - Loveshack Enter
Yonder: The Clo - Prideful Sloth
FOX n FORESTS - Bonus Level Ent
Little Nightmar - Tarsier Studios
Hyrule Warriors - Koei Tecmo Game
Mega Man Legacy - Capcom
Mega Man Legacy - Digital Eclipse
Mega Man Legacy - Capcom
Runner3 - Choice Provisio
Disco Dodgeball - Zen Studios
Bloodstained: C - Inti Creates
N++ - Metanet Softwar
Jumping Joe & F - Vixa Games / Qu
Ikaruga - Treasure
'Yoku''s Island - Villa Gorilla
Street Fighter: - Capcom
Fallen Legion: - YummyYummyTummy
Pokemon Quest - Game Freak
Legend of Kay A - Kaiko
West of Loathin - Asymmetric Publ
Just Shapes & B - Berzerk Studio
ICEY - X.D. Network In
Smoke and Sacri - Solar Sail Game
Milanoir - Italo Games
BlazBlue: Cross - Arc System Work
Happy Birthdays - Arc System Work
Shaq Fu: A Lege - Big Deez Produc
Shape of the Wo - Hollow Tree Gam
The Banner Saga - Stoic
Sushi Striker: - Indies Zero
Legendary Eleve - Eclipse Games
Hollow Knight - Team Cherry
Fortnite - Epic Games
Paladins: Champ - Hi-Rez Studios
Hexologic - MythicOwl
Splatoon 2: Oct - Nintendo
LEGO The Incred - TT Games
Flashback - Paul Cuisset
Musynx - PM Studios Inc.
The Lost Child - Kadokawa
Pode - Henchman & Goon
Mario Tennis Ac - Camelot Softwar
Lumines Remaste - Enhance Games
Mario + Rabbids - Ubisoft Milan
Ys VIII: Lacrim - Falcom
de Blob - Blue Tongue Ent
INSIDE - PLAYDEAD
LIMBO - PLAYDEAD
Figment - Bedtime Digital
Wolfenstein II: - Panic Button, M
Crash Bandicoot - Vicarious Visio
Runbow - 13AM Games
Pocket Rumble - Chucklefish
Mushroom Wars 2 - Zillion Whales
Another World - The Digital Lou
Pato Box - Bromio
'The Lion''s So - 'Mi''pu''mi Gam
20XX - Batterystaple G
Bomber Crew - Runner Duck
Shining Resonan - Sega
Bomb Chicken - Nitrome
Galak-Z: Varian - GungHo, 17-Bit
Octopath Travel - Square Enix, Ac
Captain Toad: T - Nintendo EAD To
Sonic Mania Plu - Sega
Hand of Fate 2 - Defiant Develop
Touhou Genso Wa - Mediascape
Adventure Time: - Bandai Namco Ga
Pool Panic - Rekim
Heroki - Picomy
Mega Man X Lega - Capcom
Mega Man X Lega - Capcom
Semblance - Nyamakop
Mega Man X Lega - Capcom
The Banner Saga - Stoic
2064: Read Only - MidBoss
Candle: The Pow - Teku Studios
Crossing Souls - Fourattic
Sleep Tight - We Are Fuzzy
Go Vacation - Bandai Namco Ga
Hello Neighbor - tinyBuild
Code of Princes - Nicalis
Titan Quest - THQ Nordic
Iconoclasts - MP2 Games
Flat Heroes - Parallel Circle
Salt and Sanctu - Ska Studios
Dead Cells - Motion Twin
Flipping Death - Zoink!
Overcooked! 2 - Ghost Town Game
Okami HD - Capcom
Minit - JW, Kitty, Juki
Cosmic Star Her - Zeboyd Games
State of Mind - Daedalic Entert
Keep Talking an - Steel Crate Gam
CastleStorm - Zen Studios
Detective Gallo - Footprints Game
Bad North - Plausible Conce
Morphies Law - Cosmoscope GmbH
Flood of Light - Irisloft
Little Dragons - Aksys Games
Into the Breach - Subset Games
Victor Vran: Ov - Haemimont Games
Monster Hunter - Capcom
Blade Strangers - Studio Saizense
The Messenger - Sabotage Studio
Mini Metro - Dinosaur Polo C
Freedom Planet - GalaxyTrail
Planet Alpha - Adrian Lazar
Hyper Light Dri - Heart Machine
SNK Heroines: T - SNK Corporation
Bastion - Supergiant Game
'Wasteland 2: D - InXile Entertai
Old School Musi - La Moutarde
Final Fantasy X - Square Enix
Cities: Skyline - Tantalus
Senran Kagura R - Honey Parade Ga
Xenoblade Chron - Monolith Soft
Nintendo Labo: - Nintendo
Undertale - tobyfox
'Capcom Beat '' - Capcom
Labyrinth of Re - Nippon Ichi Sof
Velocity 2X - FuturLab
The Gardens Bet - The Voxel Agent
'Broken Sword 5 - Ravenscourt
Valkyria Chroni - Sega
Arena of Valor - Tencent, Tencen
Giana Sisters: - Black Forest Ga
FIFA 19 - EA Sports
The Escapists: - Mouldy Toof Stu
This is the Pol - Weappy Studio
Wandersong - Dumb and Fat Ga
Armello - League of Geeks
Dragon Ball Fig - Arc System Work
Marble It Up! - Bad Habit Produ
Mega Man 11 - Capcom
'Overcooked! 2: - Ghost Town Game
Super Mario Par - Nintendo, Nd Cu
Guacamelee! Sup - DrinkBox Studio
Disgaea 1 Compl - Nippon Ichi Sof
Child of Light - Ubisoft Montrea
Tricky Towers - WeirdBeard
The World Ends - h.a.n.d. Inc.,
Valkyria Chroni - Sega
LEGO DC Super-V - TT Games
Starlink: Battl - Ubisoft Toronto
Warriors Orochi - Omega Force
The Jackbox Par - Jackbox Games,
The Room - Fireproof Games
Zarvot - Snowhydra llc
SINNER: Sacrifi - Another Indie
Dark Souls Rema - From Software
WindJammers - Data East, DotE
Just Dance 2019 - Ubisoft Paris
Nickelodeon Kar - Maximum Games
Pinstripe - Armor Games
Friday the 13th - Blue Wizard Dig
'My Hero One''s - Bandai Namco Ga
Yomawari: The L - Nippon Ichi Sof
LEGO Harry Pott - Warner Bros. In
Mutant Football - Nighthawk Inter
Save me Mr Tako - Nicalis
Gal Metal - DMM GAMES
Transistor - Supergiant Game
Diablo III: Ete - Blizzard Entert
'Taiko no Tatsu - Bandai Namco Ga
Moonlighter - 11 bit studios,
Rogue Legacy - Cellar Door Gam
World of Final - Square Enix
Road Redemption - Dark Seas Games
GRIP: Combat Ra - Caged Element I
Carnival Games - Mass Media
Valiant Hearts: - Ubisoft Montpel
Mercenaries Win - RideonJapan,Inc
SNK 40th Annive - SNK
'Sid Meier''s C - Aspyr
'Pokemon: Let'' - Game Freak
'Pokemon: Let'' - Game Freak
Nidhogg 2 - Messhof
This War of Min - 11 bit studios
Horizon Chase T - Aquiris Game St
R-Type Dimensio - Southend Intera
ABZU - Giant Squid
Cattails - Falcon Developm
NAIRI: Tower of - Homebear Studio
Asterix & Obeli - Etranges Libell
OkunoKA - Caracal Games
ARK: Survival E - Studio Wildcard
Monster Boy and - FDG Entertainme
Toki - Microids
Gear.Club Unlim - Eden Games Mobi
Super Smash Bro - Nintendo, HAL L
Katamari Damacy - Bandai Namco Ga
Sega Genesis Cl - Various
Guacamelee! 2 - DrinkBox Studio
Kingdom: Two Cr - Raw Fury, Noio
EVERSPACE: Stel - ROCKFISH Games
Desert Child - Oscar Brittain
GRIS - Nomada Studio
RollerCoaster T - Nvizzio Creatio
Battle Princess - Causal Bit Game
Sundered: Eldri - Thunder Lotus G
Aaero: Complete - Mad Fellows Ltd
Dynasty Warrior - Omega Force
Fitness Boxing - Imagineer Co.,L
Sega Ages: OutR - Sega
Bury me, my Lov - Plug In Digital
Double Cross - 13AM Games
Tales of Vesper - Bandai Namco Ga
New Super Mario - Nintendo
Onimusha: Warlo - Capcom, NeoBard
Octahedron: Tra - Demimonde
Fairy Fencer F: - Compile Heart
YIIK: A Postmod - Ackkstudios
Travis Strikes - Grasshopper Man
Unruly Heroes - Magic Design St
My Memory of Us - Juggler Games /
Pikuniku - Sectordub
LEGRAND LEGACY: - Another Indie
Mages of Mystra - Borealys Games
Sphinx and the - Eurocom
Downwell - Moppin
Tangledeep - Impact Gamework
Wargroove - Chucklefish
BlazBlue: Centr - Arc System Work
Observer - Bloober Team
The Liar Prince - Nippon Ichi Sof
Tetris 99 - Arika, Nintendo
Final Fantasy I - SquareSoft
Modern Combat: - Gameloft
ToeJam & Earl: - Humanature Stud
X-Morph: Defens - EXOR Studios
Aragami: Shadow - Lince Works
Q.U.B.E. 2 - Toxic Games
Trials Rising - RedLynx
Ape Out - Gabe Cuzzillo
Assault Android - Witch Beam
Claybook - Second Order
The Caligula Ef - Aquria
Baba Is You - Hempuli Oy, MP2
Captain Toad: T - Nintendo Softwa
'Chocobo''s Mys - Square Enix
Unravel Two - Coldwood Intera
Dragon Marked F - Inti Creates
'Yoshi''s Craft - Good-Feel
