Mass Effect 3: - Straight Right
Madden NFL 13 - EA Tiburon
Scribblenauts U - 5TH Cell
FIFA Soccer 13 - Electronic Arts
ESPN Sports Con - Ubisoft
'Assassin''s Cr - Ubisoft Quebec
NBA 2K13 - Visual Concepts
Darksiders II - Vigil Games
Batman: Arkham - Rocksteady Stud
'Trine 2: Direc - Frozenbyte, Inc
New Super Mario - Nintendo
Tekken Tag Tour - Namco Bandai Ga
Call of Duty: B - Treyarch
Mighty Switch F - WayForward
Skylanders Gian - Vicarious Visio
Little Inferno - Tomorrow Corpor
Sonic & All-Sta - Sumo Digital
Nintendo Land - Nintendo
ZombiU - Ubisoft Montpel
Your Shape: Fit - Blue Byte
Nano Assault Ne - 'Shin''en'
'Ninja Gaiden 3 - Team Ninja
Just Dance 4 - Ubisoft Paris
Warriors Orochi - Omega Force
Chasing Aurora - Broken Rules
SiNG Party - FreeStyleGames
Disney Epic Mic - Heavy Iron Stud
Transformers Pr - Now Production
Rabbids Land - Ubisoft Paris
Funky Barn - Tantalus
Tank! Tank! Tan - Namco Bandai Ga
Ben 10: Omniver - Vicious Cycle
Game Party Cham - Phosphor Games
Marvel Avengers - Ubisoft Quebec
Family Party: 3 - Art Co., Ltd.
The Cave - Double Fine Pro
Puddle - Neko Entertainm
Bit.Trip Presen - Gaijin Games
The Amazing Spi - Beenox
LEGO City Under - TT Games
Need for Speed: - Criterion Games
Monster Hunter - Capcom
Toki Tori 2 - Two Tribes
Kung Fu Rabbit - Neko Entertainm
Resident Evil: - Capcom
LEGO Batman 2: - TT Games
Mutant Mudds De - Renegade Kid
New Super Luigi - Nintendo
Game & Wario - Intelligent Sys
Star Wars Pinba - Zen Studios
Cloudberry King - Pwnee Studios
Pikmin 3 - Nintendo
Disney Planes - Behaviour Inter
'Spin the Bottl - Redgrim AB
Disney DuckTale - WayForward
Disney Infinity - Avalanche Softw
Pokemon Rumble - Ambrella
Rayman Legends - Ubisoft Montpel
Dungeons & Drag - Iron Galaxy Stu
The Wonderful 1 - PlatinumGames
The Legend of Z - Nintendo, HexaD
Scribblenauts U - 5TH Cell
Just Dance 2014 - Ubisoft
Skylanders Swap - Vicarious Visio
'Deus Ex: Human - Eidos Montreal,
LEGO Marvel Sup - TT Games
Wii Party U - Nd Cube
Sonic: Lost Wor - Sonic Team
Pac-Man and the - Namco Bandai Ga
Wii Fit U - Nintendo
Wii Sports Club - Nintendo
Mario & Sonic a - Nintendo, Sega
'Adventure Time - WayForward
Edge - Two Tribes
The Mysterious - Neko Entertainm
Super Mario 3D - Nintendo
RUSH - Two Tribes
NES Remix - Indies Zero
Knytt Undergrou - nifflas
CastleStorm - Zen Studios
Dr. Luigi - Arika, Nintendo
Unepic - EnjoyUp Games
F1 Race Stars: - Codemasters
Donkey Kong Cou - Retro Studios
Blok Drop U - RCMADIAX
Pure Chess - VooFoo Studios
NES Remix 2 - Indies Zero
Child of Light - Ubisoft Montrea
Stick it to the - Zoink!
Abyss - EnjoyUp Games
Scram Kitty and - Dakko Dakko
Swords & Soldie - Two Tribes
Squids Odyssey - The Game Bakers
Mario Kart 8 - Nintendo
Pushmo World - Intelligent Sys
Another World: - The Digital Lou
How to Survive - EKO Software
Shovel Knight - Yacht Club Game
Guacamelee! Sup - DrinkBox Studio
Armillo - Fuzzy Wuzzy Gam
One Piece: Unli - Ganbarion
'Wooden Sen''Se - Upper Byte
Super Toy Cars - Eclipse Games
XType Plus - PhobosLab
The Fall - Over The Moon
SteamWorld Dig - Image & Form
Cubemen 2 - 3 Sprockets
Ice Cream Surfe - Dolores Enterta
Teslagrad - Rain Games
Bayonetta 2 - PlatinumGames
Hyrule Warriors - Omega Force
Art of Balance - 'Shin''en'
'Lone Survivor: - Curve Studios,
Paper Monsters - Mobot Studios L
Bayonetta - Bee Tribe
Stealth Inc 2: - Curve Digital
Tetrobot and Co - Swing Swing Sub
Cosmophony - Moving Player
Sonic Boom: Ris - Big Red Button
Mario Kart 8 DL - Nintendo
Tengami - Nyamyam
Watch Dogs - Ubisoft Romania
Super Smash Bro - Bandai Namco Ga
Captain Toad: T - Nintendo EAD To
'Shantae and th - WayForward
Chariot - Frima Studio
Citizens of Ear - Eden Industries
Kirby and the R - HAL Labs
Mario vs. Donke - Nintendo, Ninte
Elliot Quest - Ansimuz Games
Mario Party 10 - Nintendo, Nd Cu
Underground - Grendel Games
Affordable Spac - KnapNok Games
Mario Kart 8 DL - Nintendo
Nihilumbra - BEAUTIFUN GAMES
Ultratron - Puppy Games, Ca
Swords & Soldie - Ronimo Games
'Don''t Starve: - Klei Entertainm
Splatoon - Nintendo
Adventures of P - TicToc Games
Cube Life: Isla - Cypronia
Art Academy: Ho - Headstrong Game
Roving Rogue - Padaone Games
Canvaleon - OXiAB Game Stud
Legend of Kay A - Neon Studios, K
BADLAND: Game o - Frogmind
Freedom Planet - GalaxyTrail
Runbow - 13AM Games
'Devil''s Third - Valhalla Game S
Gunman Clive HD - Horberg Product
'Q.U.B.E. Direc - Toxic Games
Super Mario Mak - Nintendo
Year Walk - Simogo
Skylanders Supe - Vicarious Visio
Extreme Exorcis - Golden Ruby Gam
'Yoshi''s Wooll - Good-Feel
Just Dance 2016 - Ubisoft
Fatal Frame: Ma - Koei Tecmo Game
Human Resource - Tomorrow Corpor
Electronic Supe - Michael Todd Ga
Rodea the Sky S - Prope, Kadokawa
Animal Crossing - Nintendo, Nd Cu
Typoman - Brainseed Facto
Mario Tennis: U - Nintendo, Camel
Xenoblade Chron - Monolith Soft
FAST Racing NEO - 'Shin''en'
Temple of Yog - CHUDCHUD INDUST
Minecraft: Wii - 4J Studios
Shadow Puppetee - Sarepta studio
The Legend of Z - Tantalus, Tanta
Mutant Mudds: S - Renegade Kid
Pokken Tourname - Bandai Namco Ga
Star Fox Guard - Nintendo, Plati
Star Fox Zero - PlatinumGames
Mighty No. 9 - Inti Creates
Tokyo Mirage Se - Atlus
Mario & Sonic a - Nintendo, Sega
Axiom Verge - Tom Happ
Jotun: Valhalla - Thunder Lotus G
Noitu Love: Dev - Konjak, MP2 Gam
Severed - DrinkBox Studio
Paper Mario: Co - Nintendo, Intel
SteamWorld Heis - Image & Form
Shantae: Half-G - WayForward
The Legend of Z - Nintendo
