Hot Shots Golf: - Clap Hanz
ModNation Racer - SCEA
BlazBlue: Conti - Arc System Work
Super Stardust - Housemarque
Escape Plan - Fun Bits
Rayman Origins - UBlart Montpell
Lumines: Electr - Q Entertainment
Uncharted: Gold - Naughty Dog, So
Ultimate Marvel - Capcom
FIFA Soccer - Electronic Arts
Wipeout 2048 - Studio Liverpoo
Virtua Tennis 4 - Sega
F1 2011 - Codemasters
Michael Jackson - Ubisoft
Little Deviants - Bigbig Studios
Dungeon Hunter: - Ubisoft
Asphalt: Inject - Ubisoft
Tales From Spac - DrinkBox Studio
Plants vs. Zomb - PopCap
Hustle Kings - VooFoo Studios
Ninja Gaiden Si - Team Ninja
Touch My Katama - Bandai Namco Ga
Dynasty Warrior - Koei, Omega For
Army Corps of H - Entersphere, In
Shinobido 2: Re - Acquire
StarDrone Extre - Beatshapers
MotorStorm RC - Evolution Studi
MLB 12: The Sho - SCEA San Diego
Unit 13 - Zipper Interact
LEGO Harry Pott - 'Traveller''s T
Reality Fighter - Novarama
Ridge Racer - Namco Bandai Ga
Sumioni: Demon - Acquire
Disgaea 3: Abse - Nippon Ichi Sof
Mortal Kombat - NetherRealm Stu
Table Top Tanks - Devils Details
Resistance: Bur - Nihilistic
Gravity Rush - SCE Japan Studi
Metal Gear Soli - Armature Studio
LEGO Batman 2: - TT Games
Puddle - Neko Entertainm
Sound Shapes - SCEA
LittleBigPlanet - Tarsier Studios
FIFA Soccer 13 - Electronic Arts
'New Little Kin - Konami
Retro City Ramp - Vblank Entertai
Spy Hunter - TT Fusion
Dokuro - Game Arts
Silent Hill: Bo - WayForward
'Zero Escape: V - ChunSoft
Street Fighter - Capcom
Frobisher Says! - Honeyslug Ltd
Smart as... - XDEV
Super Monkey Ba - Marvelous AQL
Orgarhythm - Acquire
Need for Speed: - Criterion Games
'Assassin''s Cr - Ubisoft
Ragnarok Odysse - Game Arts
LEGO The Lord o - TT Games
When Vikings At - Clever Beans
Call of Duty: B - Nihilistic
Alien Breed (PS - Team 17
Persona 4 Golde - Atlus
Sine Mora - Digital Reality
PlayStation All - Bluepoint Games
Uncharted: Figh - Sony Bend
Big Sky: Infini - VooFoo Studios,
'Oddworld: Stra - Just Add Water
Sonic & All-Sta - Sumo Digital
Chronovolt - Playerthree
Earth Defense F - Sandlot
Lets Fish! Hook - SIMS
Sly Cooper: Thi - Sanzaru Games
Rocketbirds: Ha - Ratloop Asia Pt
Alien Breed - Team 17
Ninja Gaiden Si - Team Ninja
MLB 13: The Sho - SCEA San Diego
Dead or Alive 5 - Team Ninja
Guacamelee! - DrinkBox Studio
Table Mini Golf - Four Door Lemon
Thomas Was Alon - Mike Bithell
Soul Sacrifice - SCE Japan Studi
Jacob Jones and - Lucid Games
'Men''s Room Ma - Sawfly Studios
Quell Memento - Fallen Tree Gam
Jak and Daxter - Mass Media
Disney Epic Mic - Blitz Games, Di
Hotline Miami - Abstraction Gam
Muramasa Rebirt - Vanillaware
Velocity Ultra - FuturLab
Stealth Inc: A - Curve Studios
PixelJunk Monst - Double Eleven
'Dragon''s Crow - Vanillaware
Open Me! - SCEI
The Walking Dea - Telltale Games
Spelunky - Mossmouth
Rayman Legends - Ubisoft Montpel
KickBeat - Zen Studios
Killzone: Merce - Guerilla Cambri
Real Boxing - Vivid Games
'Lone Survivor: - Curve Studios,
Atelier Meruru - Gust
Worms Revolutio - Team 17
Atomic Ninjas - Grip Games
Valhalla Knight - K2
Batman: Arkham - Armature Studio
Proteus - Ed Key and Davi
CastleStorm - Zen Studios
The Amazing Spi - Mercenary Techn
Tearaway - Media Molecule
Ys: Memories of - Falcom
Rainbow Moon - SideQuest Studi
Doki-Doki Unive - SCEA
Sorcery Saga: T - Zerodiv
Terraria - Engine Software
Bit.Trip Presen - Gaijin Games
OlliOlli - Tom Hegarty
Dragon Ball Z: - Artdink
Surge Deluxe - FuturLab
Dustforce - Hitbox , QLOC
King Oddball - 10tons Ltd, 10t
TxK - Llamasoft
Danganronpa: Tr - Spike Chunsoft
Toukiden: The A - Omega Force
Gunslugs - Abstraction Gam
Hatsune Miku: P - Sega
Final Fantasy X - Virtuos
Luftrausers - Vlambeer
Deception IV: B - Koei Tecmo Game
Destiny of Spir - Q Entertainment
Football Manage - Sports Interact
Dead Nation - 
Conception II: - Spike
Demon Gaze - Experience Inc.
God of War Coll - Sanzaru Games,
Borderlands 2 - Iron Galaxy Stu
Soul Sacrifice - SCE Japan Studi
The Sly Collect - Sanzaru Games
Monster Monpiec - Compile Heart
Lemmings Touch - d3t Ltd
Mind Zero - Zerodiv
PlayStation Vit - Spiral House
Hyperdimension - Tamsoft
Magical Beat - Arc System Work
Child of Light - Ubisoft Montrea
Atelier Rorona - Gust
Rogue Legacy - Cellar Door Gam
Ratchet & Clank - Mass Media
Metrico - Digital Dreams
Table Top Racin - Playrise Edge L
Disgaea 4: A Pr - Nippon Ichi Sof
Gravity Crash U - Just Add Water
Phantom Breaker - Division2
'Akiba''s Trip: - Acquire
Sword Art Onlin - Bandai Namco Ga
Velocity 2X - FuturLab
Danganronpa 2: - Spike Chunsoft
Murasaki Baby - Ovosonico
Run Like Hell! - Mass Creation
Frozen Synapse - Double Eleven
Invizimals: The - Novarama
Futuridium EP D - MixedBag Srl
Natural Doctrin - Kadokawa
Jet Car Stunts - True Axis
Minecraft: Play - 4J Studios, Moj
Senran Kagura S - Tamsoft, Marvel
Freedom Wars - Dimps Corporati
Tales of Hearts - 7thChord
Senran Kagura: - Meteorise
Hatsune Miku: P - Sega
'Oddworld: Munc - Just Add Water
Woah Dave! - Choice Provisio
Duke Nukem 3D: - Abstraction Gam
Joe Danger 2: T - Four Door Lemon
Atelier Ayesha - Gust
Grim Fandango R - Double Fine Pro
Nihilumbra - BEAUTIFUN GAMES
Baboon! - Relevo
Criminal Girls: - Image Epoch, Im
Kick & Fennick - Jaywalkers Inte
Jungle Rumble: - Disco Pixel
Hyperdevotion N - Sting
htoL#NiQ: The F - Nippon Ichi Sof
OlliOlli2: Welc - roll7
Oreshika: Taint - Alfa System
La-Mulana EX - Pygmy Studio
Flame Over - Laughing Jackal
Tokyo Twilight - TOYBOX
Soldner-X 2: Fi - SideQuest Studi
Damascus Gear: - Arc System Work
MonsterBag - IguanaBee
Sayonara Umihar - Studio Saizense
Hyperdimension - Tamsoft
Operation Abyss - Experience Inc.
Samurai Warrior - Omega Force
Ar nosurge Plus - Gust
Lost Dimension - FuRyu
Actual Sunlight - 'Will O''Neill,
Dungeon Travele - Aqua Plus
Resident Evil: - Frima Studio
Amnesia: Memori - Idea Factory
Danganronpa Ano - Spike Chunsoft
The Muppets: Mo - Virtual Toys
Persona 4: Danc - Atlus, Dingo In
Dengeki Bunko: - Sega, French-Br
Corpse Party: B - 5pb
Code:Realize - - Otomate
Norn9: Var Comm - Idea Factory, O
SUPERBEAT: XONi - Nurijoy
Dynasty Warrior - Omega Force
BigFest - On The Metal Lt
Earth Defense F - Sandlot
The Legend of H - Falcom
Atelier Escha & - Gust
SwapQuest - Constantin Graf
XCOM: Enemy Unk - Firaxis Games
Trillion: God o - Compile Heart
Skullgirls: 2nd - Lab Zero Games
Severed - DrinkBox Studio
Stranger of Swo - Experience Inc.
Ray Gigant - Bandai Namco Ga
MegaTagmension - Compile Heart
Grand Kingdom - Spike Chunsoft
Zero Escape: Ze - Spike Chunsoft,
Adventures of M - Square Enix
Mobile Suit Gun - Lancarse, Banda
Shiren the Wand - Spike Chunsoft
A.W.: Phoenix F - Bandai Namco Ga
The Legend of H - Falcom
Psycho-Pass: Ma - 5pb
MeiQ: Labyrinth - Compile Heart
Criminal Girls - Nippon Ichi Sof
Valkyrie Drive: - Marvelous Inc.
Superdimension - Compile Heart
Exist Archive: - Tri-Ace
Yomawari: Night - Nippon Ichi Sof
Atelier Shallie - Gust
A Rose in the T - Nippon Ichi Sof
The Caligula Ef - Aquria
Hakuoki: Kyoto - Idea Factory, O
Operation Babel - Experience Inc.
Tokyo Xanadu - Falcom
Collar x Malice - Otomate
Drive Girls - Tamsoft
Mary Skelter: N - Compile Heart
Danganronpa V3: - Spike Chunsoft
Bad Apple Wars - Otomate
Tokyo Tattoo Gi - SUSHI TYPHOON G
Hakuoki: Edo Bl - Otomate
